10 10 2 2 2 2 2 2 2 2 2
10 10 2 4 2 7 2 4 2 6 2
10 2 2 0 1 0 1 0 1 0 2
4 8 0 0 0 0 0 0 0 0 3
10 2 2 0 1 0 1 0 1 0 2
10 10 2 9 2 4 2 5 2 4 2
10 10 2 2 2 2 2 2 2 2 2