2 2 2 2 2
3 0 0 0 2
2 1 1 5 2
2 9 0 0 2
2 8 2 2 2
10 4 10 10 10