10 10 4 10 4 4 4 10
2 2 8 1 0 0 0 2
2 0 0 1 0 1 0 2
2 2 0 0 0 1 3 2
10 2 2 2 2 10 10 2