1 3 1 1 1
1 6 0 0 1
1 8 4 0 1
1 0 0 0 1
1 1 1 7 1